111111111111111111
1N1000000000000001
100010000001000001
100010110010010001
100010001000000001
100010000100001001
101000000000100001
111111111111111111