111111111111111
100001000100001
101010001001001
1000100100000S1
111111111111111