F  4,   4  ,4
C     225, 0,2     
NO path/to_the_north_texture             
SO path/to_the_south_texture
WE path/to_the_west_texture
EA path/to_the_east_texture



   11111111111111111111111111111             11111111111111111111111111111111111111111111111111111111111
111000000000000000000000000001111111111111111110001    1000000000000010000000000110000000000000000000001
111111000000000000000000000000000000000000000000001    1000000000000100S0000001000000000000000000000011
    11111100000000000000000011111111111111111000001    100000000000001000000000000000000000000000000011
        1111110000000000111111            111111111    10000000000000000000000000000000000000000000011
            11111111001111111111                       1000000000000000000000000000000000000000000011
                  110011                        11111111111111110111111111111111111111111111111111111
11111111111111111111001111111111111111111111111110000000000000000111111111111111111111111111111111
1111111111111111111100111111111111111111111111111000000111111111111111111111111111111111111111111111111
                  110011                     111100000011
                  110011                     10000000011
                  110011                     100111100011            
                  110011                     1001  100011
             111111111111111111111111111111111111111111111111111111111111
