


F  4, 5  ,4 
C 225,   80 ,2


NO path/to_the_north_texture
SO path/to_the_south_texture
WE path/to_the_west_texture
EA path/to_the_east_texture

   11111111111111111111111111111             111111111111111111111111111111111111111111111111111111111
111000000000000000000000000001111111111111111110001    100000000000001000000000011000000000000000000001  
111111000000000000000000000000000000000000000000001    1000000000000100S00000010000000000000000000000111111
    11111100000000000000000011111111111111111000001    100000000000001000000000000000000000000000000011
        1111110000000000111111            111111111    10000000000000000000000000000000000000000000011
            11111111001111111111                       1000000000000000000000000000000000000000000011
                  110011                        11111111111111110111111111111111111111111111111111111
11111111111111111111001111111111111111111111111110000000000000000111111111111111111111111111111111
111111111111111111110011111111111111111111111111100000011111111111111111111111111111111111111111111111111111111
                  110011                      111100000011
                  110011                     10000000011
                  110011                     100111100011            
                  110011                     1001  100011
            111111111111111111111111111111111111111111111111111111111111