SO                 ./textures/path_to_the_south_texture                                           

F 255     ,        255   ,    255

C 30,   10,   70

NO                  ./textures/path_to_the_north_texture                            

WE                      ./textures/path_to_the_west_texture                   


EA  ./textures/row.xpm

11111111111111111111111111111
10000000000000000000000000001
10000000000000000000000000001
10000000000000000000000000001
100000000000S0000000000000001
10000000000000000001000000001
10000000000000000000000000001
10000000000000000000000000001
11111111111111111111111111111
