


F  4, 5  ,4  
C    225, 0,2


NO      path/to_the_north_texture
SO path/to_the_south_texture
WE path/to_the_west_texture
EA path/to_the_east_texture

11111111111111111111111111111111111111111
1S000000000000111000000000000000000000001
111111000000001 1000000000000000000000001
1   1111110000010000000000000000000000001
1        10011000000000000000000000000001
11111111110011111000001100000000000000001
11100000000000111000000000000000000000001
111111000000001 1000001100000000000000011
1   1111110000010000000000000000000000001
1       111111000000000000000000000000001
11111111110011111000001100000000000000001
11100000000000111000000000000000000000001
11111111111111111111111111111111111111111